border_size=1
usage=map

Ms          , Ms          , Ms          , Ms          , Ms          , Ms          , Ms          , Ms          , Ms          , Ms          , Ms          , Ms          , Ms          , Ms          , Ms          , Ms          , Ms          , Ms          , Ha^Fpa      , Ha^Fpa      , Ha^Fpa      , Aa^Fma      , Gs^Fmw      , Gs^Fmw      , Gs^Fmw      , Gs^Fmw      , Aa^Fma      , Aa          , Gg          , Gg          , Gg          , Gg          , Gg          , Gs^Fmw      , Gs^Fmw      , Gs^Fmw      , Aa^Fma      
Mm^Xm       , Ms          , Mm^Xm       , Mm^Xm       , Mm^Xm       , Mm^Xm       , Mm^Xm       , Mm^Xm       , Ms          , Ms          , Ms          , Ms          , Ms          , Ms          , Ms          , Ms          , Ha^Fpa      , Ms          , Ha^Fpa      , Ha^Fpa      , Aa^Fma      , Aa^Fma      , Gs^Fmw      , Gs^Fmw      , Aa^Fma      , Aa^Fma      , Gg          , Aa          , Gg          , Gg          , Gg          , Gg          , Gg          , Gs^Fmw      , Gs^Fmw      , Aa^Fma      , Aa^Fma      
Ms          , Mm^Xm       , Ms          , Mm^Xm       , Ms          , Mm^Xm       , Ms          , Mm^Xm       , Ms          , Ms          , Mm          , Ms          , Ms          , Ms          , Ms          , Ha^Fpa      , Ha^Fpa      , Ha^Fpa      , Ha^Fpa      , Aa^Fma      , Aa^Fma      , Gs^Fmw      , Gs^Fmw      , Gg          , Gg          , Gg          , Gg          , Gg          , Gg          , Gg          , Gg          , 2 Gg        , Gs^Fmw      , Gs^Fmw      , Gs^Fmw      , Aa^Fma      , Ha^Fpa      
Ms          , Ms          , Ms          , Ms          , Ms          , Ms          , Ms          , Ms          , Ms          , Ms          , Ms          , Ms          , Ms          , Ms          , Ms          , Ms          , Ha^Fpa      , Ha^Fpa      , Aa^Fma      , Aa^Fma      , Aa^Fma      , Gs^Fmw      , Gg          , Gg          , Gg          , Gg          , Gg          , Gg          , Gg          , Gg          , Aa          , Aa          , Aa^Fma      , Gs^Fmw      , Aa^Fma      , Aa^Fma      , Ha^Fpa      
Ms          , Ms          , Ms          , Ms          , Ms          , Ms          , Ms          , Ms          , Ms          , Ms          , Ms          , Ms          , Ha^Voa      , Ha^Fpa      , Ha^Fpa      , Ha^Fpa      , Ha^Fpa      , Aa^Fma      , Gs^Fmw      , Aa^Fma      , Gs^Fmw      , Aa^Fma      , Gg          , Gg          , Gg          , Gg          , Gg          , Gg          , Gg          , Gg          , Aa          , Aa^Fma      , Aa^Voa      , Aa^Fma      , Aa^Fma      , Ha^Fpa      , Ha^Fpa      
Ms          , Ms          , Ms          , Ms          , Ms          , Ms          , Ms          , Ms          , Ms          , Ms          , Ha^Fpa      , Ha^Fpa      , Ha^Fpa      , Ha^Fpa      , Aa^Fma      , Ha^Fpa      , Gs^Fmw      , Gs^Fmw      , Aa^Fma      , Gs^Fmw      , Gs^Fmw      , Aa^Fma      , Gg          , Gg          , Gg          , Gg          , Gg          , Gg          , Gg          , Gg          , Gg          , Aa^Fma      , Gs^Fmw      , Aa^Fma      , Aa^Fma      , Ha^Fpa      , Ha^Fpa      
Ms          , Ms          , Ms          , Ms          , Ms          , Ms          , Ha^Fpa      , Ms          , Ha^Fpa      , Ha^Fpa      , Ha^Fpa      , Ha^Fpa      , Aa^Fma      , Aa^Fma      , Aa^Fma      , Aa^Fma      , Aa^Fma      , Gs^Fmw      , Aa^Fma      , Gs^Fmw      , Aa^Vha      , Aa          , Gg          , Gg          , Gg          , Gg          , Gg          , Gg          , Gg          , Gg          , Gg          , Aa^Fma      , Gs^Fmw      , Aa^Fma      , Ha^Fpa      , Ha^Fpa      , Ms          
Ms          , Ha^Fpa      , Ha^Fpa      , Ha^Fpa      , Ha^Fpa      , Ha^Fpa      , Ha^Fpa      , Ha^Fpa      , Ha^Fpa      , Aa^Fma      , Aa^Fma      , Aa^Fma      , Aa^Fma      , Aa^Fma      , Aa^Fma      , Aa^Fma      , Aa^Fma      , Gs^Fmw      , Gs^Fmw      , Gs^Fmw      , Aa          , Gg          , Gg          , Gg          , Gg          , Gg          , Gg          , Gg          , Gg          , Gg          , Gs^Fmw      , Aa^Fma      , Gs^Fmw      , Ha^Fpa      , Ha^Fpa      , Ha^Fpa      , Ms          
Ms          , Ha^Fpa      , Ha^Fpa      , Ha^Fpa      , Ha^Fpa      , Ha^Fpa      , Ha^Fpa      , Aa^Fma      , Aa^Fma      , Aa^Fma      , Aa^Fma      , Aa^Fma      , Gs^Fmw      , Gs^Fmw      , Gs^Fmw      , Aa^Fma      , Aa^Fma      , Aa^Fma      , Gg          , Gg          , Gg          , Gg          , Gg          , Gg          , Gg          , Gg          , Gg          , Gg          , Gg          , Gg          , Gs^Fmw      , Gs^Fmw      , Aa^Fma      , Ha^Fpa      , Ha^Fpa      , Ha^Fpa      , Ms          
Ms          , Ms          , Ms          , Ha^Fpa      , Ha^Fpa      , Ha^Fpa      , Ha^Fpa      , Aa^Fma      , Aa^Fma      , Aa^Fma      , Gs^Fmw      , Gs^Fmw      , Gs^Fmw      , Gs^Fmw      , Gs^Fmw      , Gs^Fmw      , Gg          , Gg          , Gg          , Gg          , Gg          , Gg          , Gg          , Gg          , Gg          , Gg          , Gs^Fmw      , Gg          , Gs^Fmw      , Gs^Fmw      , Aa^Fma      , Aa^Fma      , Aa^Fma      , Ha^Fpa      , Ha^Fpa      , Ms          , Ms          
Ha^Fpa      , Ms          , Ha^Fpa      , Ha^Fpa      , Ha^Fpa      , Ha^Fpa      , Aa^Fma      , Aa^Fma      , Aa^Fma      , Aa^Fma      , Gg^Vc       , Gs^Fmw      , Aa^Fma      , Gg          , Gg          , Gg          , Gg          , Gg          , Gs^Fmw      , Gg          , Gg          , Gg          , Gg          , Gg          , Gg          , Gg          , Gs^Fmw      , Gs^Fmw      , Gs^Fmw      , Gs^Fmw      , Aa^Fma      , Aa^Fma      , Aa^Fma      , Ha^Fpa      , Ha^Fpa      , Ms          , Ms          
Ha^Fpa      , Ha^Fpa      , Ha^Fpa      , Ha^Fpa      , Ha^Fpa      , Ha^Fpa      , Aa^Fma      , Aa^Fma      , Aa^Fma      , Gs^Fmw      , Aa^Fma      , Aa^Fma      , Gg          , Gg          , Gg          , Gg          , Gg          , Gs^Fmw      , Gg^Vc       , Gs^Fmw      , Gg          , Gg          , Gg          , Gg          , Aa^Fma      , Gg          , Aa^Fma      , Aa^Fma      , Gs^Fmw      , Aa^Fma      , Aa^Fma      , Aa^Fma      , Ha^Fpa      , Ha^Fpa      , Ha^Fpa      , Ms          , Ms          
Ha^Fpa      , Ha^Fpa      , Aa^Fma      , Aa^Fma      , Gs^Fmw      , Aa^Fma      , Gs^Fmw      , Gs^Fmw      , Aa^Fma      , Aa^Fma      , Aa^Fma      , Gg          , Gg          , Gg          , Gg          , Gg          , Gg          , Gs^Fmw      , Gs^Fmw      , Gs^Fmw      , Gg          , Gg          , Gg          , Gg          , Aa^Fma      , Aa^Fma      , Gs^Fmw      , Gs^Fmw      , Gs^Fmw      , Aa^Fma      , Ha^Fpa      , Ha^Fpa      , Ha^Fpa      , Ha^Fpa      , Ms          , Ms          , Ms          
Ha^Fpa      , Ha^Fpa      , Aa^Fma      , Aa^Fma      , Gs^Fmw      , Gs^Fmw      , Gs^Fmw      , Aa^Fma      , Aa^Fma      , Aa^Fma      , Gg          , Gg          , Gg          , Gg          , Gg          , Gg          , Gg          , Gg          , Gg          , Gg          , Gg          , Gg          , Gs^Fmw      , Gg          , Gs^Fmw      , Gs^Fmw      , Gs^Fmw      , Gs^Fmw      , Aa^Fma      , Aa^Fma      , Ha^Fpa      , Ha^Voa      , Ha^Fpa      , Ms          , Ms          , Ms          , Ms          
Aa^Fma      , Aa^Fma      , Gs^Fmw      , Aa^Fma      , Gs^Fmw      , Gs^Fmw      , Aa          , Aa^Fma      , Aa          , Gg          , Gg          , Gg          , Gg          , Gg          , Gg          , Gg          , Gg          , Gg          , Gg          , Gg          , Gs^Fmw      , Gs^Fmw      , Gs^Fmw      , Gs^Fmw      , Gs^Fmw      , Gs^Fmw      , Gs^Fmw      , Aa^Fma      , Gs^Fmw      , Gs^Fmw      , 1 Ha^Fpa    , Ha^Fpa      , Ha^Fpa      , Ms          , Ms          , Ms          , Ms          
Aa^Fma      , Gs^Fmw      , Gs^Fmw      , Gs^Fmw      , Gs^Fmw      , Aa          , Aa          , Aa          , Gg          , Gg          , Gg          , Gg          , Gg          , Gg          , Gg          , Gg          , Gg          , Gg          , Aa          , Gg          , Gs^Fmw      , Gs^Fmw      , Aa^Fma      , Aa^Fma      , Aa^Fma      , Aa^Fma      , Ha^Fpa      , Gs^Fmw      , Ha^Fpa      , Ha^Fpa      , Ha^Fpa      , Ha^Fpa      , Ms          , Ha^Fpa      , Ha^Fpa      , Ms          , Ms          
Gs^Fmw      , Gs^Fmw      , Gs^Fmw      , Gs^Fmw      , Gg          , Gg          , Gg          , Gg          , Gg          , Gg          , Gg          , Gg          , Gg          , Gg          , Gg          , Aa          , Aa          , Aa          , Gs^Fmw      , Gs^Fmw      , Gs^Fmw      , Aa^Fma      , Aa^Fma      , Ha^Fpa      , Ha^Fpa      , Ha^Fpa      , Ha^Fpa      , Ha^Fpa      , Ha^Fpa      , Ha^Fpa      , Ms          , Ms          , Ms          , Ms          , Ms          , Ms          , Ms          
Gs^Fmw      , Gs^Fmw      , Gs^Fmw      , Re^Vct      , Gg          , Gg          , Gg          , Gg          , Gg          , Gg          , Gg          , Gg          , Gg          , Gg          , Gg          , Aa^Vha      , Aa^Fma      , Aa^Fma      , Gs^Fmw      , Gs^Fmw      , Aa^Fma      , Aa^Fma      , Ha^Fpa      , Ha^Fpa      , Ha^Fpa      , Ha^Fpa      , Ms          , Ha^Fpa      , Ms          , Ms          , Ha^Fpa      , Ms          , Ms          , Ms          , Ms          , Ms          , Ms          
Aa^Fma      , Gs^Fmw      , Aa          , Gg          , Gg          , Gg          , Gg          , Gg          , Gg          , Gg          , Gg          , Gg          , Gg          , Gg          , Aa^Fma      , Aa^Fma      , Aa^Fma      , Aa^Fma      , Gs^Fmw      , Gs^Fmw      , Aa^Fma      , Ha^Fpa      , Ha^Fpa      , Ha^Fpa      , Ms          , Ms          , Ms          , Ms          , Ms          , Ms          , Ms          , Ha^Fpa      , Ha^Fpa      , Ms          , Ms          , Ms          , Ms          
Aa^Fma      , Aa^Fma      , Aa          , Gg          , Gg          , Gg          , Gg          , Gg          , Gg          , Gg          , Gg          , Gg          , Gs^Fmw      , Aa^Fma      , Aa^Fma      , Aa^Fma      , Aa^Fma      , Aa^Fma      , Aa^Fma      , Aa^Fma      , Aa^Fma      , Ha^Fpa      , Ha^Fpa      , Ms          , Ms          , Ms          , Ms          , Ms          , Ms          , Ms          , Ha^Fpa      , Ha^Fpa      , Ha^Fpa      , Ms          , Ms          , Ms          , Ms          
Aa^Fma      , Aa^Fma      , Gg          , Gg          , Gg          , Gg          , Gg          , Gg          , Gg          , Gg          , Gs^Fmw      , Gs^Fmw      , Aa^Fma      , Aa^Fma      , Aa^Fma      , Aa^Fma      , Aa^Fma      , Aa^Fma      , Ha^Fpa      , Aa^Fma      , Ha^Fpa      , Ha^Fpa      , Ha^Fpa      , Ms          , Ms          , Ms          , Ms          , Ms          , Ms          , Ha^Fpa      , Ha^Fpa      , Ha^Fpa      , Ms          , Ms          , Ms          , Ms          , Ms          
Aa^Fma      , Aa^Fma      , Aa          , Gg          , Gg          , Gg          , Gg          , Gg          , Gg          , Gg          , Gs^Fmw      , Gs^Fmw      , Gs^Fmw      , Aa^Fma      , Aa^Fma      , Aa^Fma      , Aa^Fma      , Ha^Fpa      , Ha^Fpa      , Ha^Fpa      , Ha^Fpa      , Ha^Fpa      , Ha^Fpa      , Ms          , Ms          , Ms          , Ms          , Ms          , Ms          , Ms          , Ms          , Ms          , Ms          , Ms          , Ms          , Ms          , Ms          
Aa^Fma      , Aa          , Gg          , Gg          , Gg          , Gg          , Gg          , Gg          , Gs^Fmw      , Gs^Fmw      , Gs^Fmw      , Gs^Fmw      , Gs^Fmw      , Gs^Fmw      , Aa^Fma      , Aa^Fma      , Ha^Fpa      , Ha^Fpa      , Ha^Fpa      , Ha^Fpa      , Ha^Fpa      , Ha^Fpa      , Ha^Fpa      , Ms          , Ms          , Ms          , Ms          , Ms          , Ms          , Ms          , Ms          , Ms          , Ms          , Ms          , Ms          , Ms          , Ms          
Aa          , Aa          , Gg          , Gg          , Gg          , Gg          , Gg          , Gs^Fmw      , Gs^Fmw      , Gs^Fmw      , Gs^Fmw      , Gs^Fmw      , Gs^Fmw      , Gs^Fmw      , Aa^Fma      , Aa^Fma      , Ha^Fpa      , Ha^Fpa      , Ha^Fpa      , Ha^Fpa      , Ms          , Ms          , Ms          , Ha^Fpa      , Ha^Fpa      , Ms          , Ms          , Ms          , Ms          , Ms          , Ms          , Ms          , Ms          , Ms          , Ms          , Ms          , Ms          
Aa          , Aa          , Gg          , Gg          , Gg          , Gg          , Gs^Fmw      , Gs^Fmw      , Gs^Fmw      , Gs^Fmw      , Gs^Fmw      , Gs^Fmw      , Aa^Fma      , Aa^Fma      , Aa^Fma      , Ha^Fpa      , Ha^Fpa      , Ha^Fpa      , Ha^Fpa      , Ms          , Ms          , Ms          , Ms          , Ha^Fpa      , Ha^Fpa      , Ha^Fpa      , Ms          , Ms          , Ms          , Ms          , Ms          , Ms          , Ms          , Ms          , Ms          , Ms          , Ms          
Gg          , Gg          , Gg          , Gg          , Gg          , Gg          , Gs^Fmw      , Gs^Fmw      , Gs^Fmw      , Gs^Fmw      , Gs^Fmw      , Gs^Fmw      , Aa^Fma      , Aa^Fma      , Ha^Fpa      , Ha^Fpa      , Ms          , Ms          , Ha^Fpa      , Ms          , Ms          , Ms          , Ms          , Ms          , Ms          , Ms          , Ms          , Ms          , Ms          , Ms          , Ms          , Ms          , Ms          , Ms          , Ms          , Ms          , Ms          
Gg          , Gg          , Gg          , Gg          , Gg          , Gs^Fmw      , Gs^Fmw      , Gs^Fmw      , Gs^Fmw      , Gs^Fmw      , Aa^Fma      , Aa^Fma      , Aa^Fma      , Ha^Fpa      , Ha^Fpa      , Ms          , Ha^Fpa      , Ha^Fpa      , Ms          , Ms          , Ms          , Ms          , Ms          , Ms          , Ms          , Ms          , Ms          , Ms          , Ms          , Ms          , Ms          , Ms          , Ms          , Ms          , Ms          , Ms          , Ms          
Gg          , Gg          , Gg          , Gg          , Gg          , Gs^Fmw      , Gs^Fmw      , Gs^Fmw      , Gs^Fmw      , Gs^Fmw      , Aa^Fma      , Aa^Fma      , Aa^Fma      , Ha^Fpa      , Ha^Fpa      , Ha^Fpa      , Ha^Fpa      , Ms          , Ms          , Ms          , Ms          , Ms          , Ms          , Ms          , Ms          , Ms          , Ms          , Ms          , Ms          , Ms          , Ms          , Ms          , Ms          , Ms          , Ms          , Ms          , Ms          
