border_size=1
usage=map

Mm^Xm       , Mm^Xm       , Mm^Xm       , Ms          , Mm^Xm       , Ms          , Mm^Xm       , Ms          , Ms          , Ms          , Ms          , Ms          , Ms          , Ms          , Ms          , Ms          , Ms          , Ms          , Ms          , Ms          , Ms          , Ms          , Ms          , Ms          , Ha          , Ha          , Ha          , Ai          , Ww          , Ha          , Ha          , Ha          , Ha          , Ha^Fma      , Ha^Fma      , Ms          , Ms          , Ms          , Ms          , Ms          , Ms          , Ms          , Ms          , Ms          , Mm^Xm       , Ms          
Ms          , Mm^Xm       , Mm^Xm       , Mm^Xm       , Mm^Xm       , Mm^Xm       , Ms          , Ms          , Ms          , Ms          , Ms          , Ha^Fma      , Ha^Fma      , Ms          , Ms          , Ms          , Ms          , Ms          , Ms          , Ha          , Ha          , Ha          , Ha          , Ms          , Ha          , Ha          , Ha          , Ai          , Ww          , Ai          , Ha          , Ha          , Ha          , Ha^Fma      , Ha^Fma      , Ha^Fma      , Ha^Fma      , Ha^Fma      , Ha^Fma      , Ms          , Ms          , Ms          , Ms          , Ms          , Mm^Xm       , Mm^Xm       
Mm^Xm       , Mm^Xm       , Ms          , Ms          , Ms          , Ms          , Ms          , Ms          , Ms          , Ms          , Ha^Fma      , Ha^Fma      , Ms          , Ms          , Ms          , Ms          , Ms          , Ms^Vhha     , Ms          , Ha          , Ha          , Ha          , Ha          , Ha          , Ha          , Ha          , Ha          , Ai          , Ww          , Ai          , Ai          , Ha          , Ha          , Ha          , Ha^Fma      , Ha^Fma      , Ha^Fma      , Ha^Fma      , Ha^Vhha     , Ha          , Ha^Fma      , Ms          , Ms          , Ms          , Mm^Xm       , Mm^Xm       
Ms          , Ms          , Ms          , Ms          , Ms          , Ms          , Ms          , Ms          , Ha^Fma      , Ha^Fma      , Ha^Vhha     , Ha          , Ha          , Ha          , Ha          , Ha          , Ha          , Ha          , Ha          , Ha          , Aa          , Ha          , Aa          , Ha          , Ai          , Ha          , Ai          , Ai          , Ww          , Ai          , Aa          , Aa          , Aa          , Ha^Fma      , Ha^Fma      , Ha^Fma      , Ha          , Ha^Fma      , Ha^Fma      , Ha^Fma      , Ms          , Ms          , Ms          , Ms          , Ms          , Ms          
Ms          , Ms          , Ms          , Ms          , Ha^Fma      , Ms          , Ha^Fma      , Ha^Fma      , Ha^Fma      , Ha^Fma      , Ha          , Ha          , Ha^Fma      , Ha          , Gg          , Gg          , Aa          , Ha          , Gg          , Aa          , Aa          , Aa          , Gg          , Gg          , Ai          , Ai          , Ww          , Ww          , Ai          , Ai          , Aa          , Aa          , Aa          , Aa          , Ha          , Ha          , Ha          , Ha^Fma      , Ha^Fma      , Ha^Fma      , Ms          , Ms          , Ms          , Ms          , Ms          , Ms          
Ms          , Ms          , Ms          , Ha^Fma      , Ha^Fma      , Ha^Fma      , Ha^Fma      , Ha^Fma      , Ha          , Ha          , Ha^Fma      , Ha^Fma      , Gg          , Gg          , Aa          , Aa          , Gg^Vl       , Gg          , Gg          , Aa          , Gg          , Gg          , Ai          , Ai          , Ww          , Ww          , Ww          , Ai          , Co          , Aa          , Aa          , Aa          , Co          , Co          , Ha          , Ha          , Ha^Fma      , Ha^Fma      , Ha^Fma      , Ha^Fma      , Ha^Fma      , Ms          , Ms          , Ms          , Ms          , Ms          
Ms          , Ms          , Ms          , Ha^Fma      , Ha^Fma      , Ha^Fma      , Aa          , Ha^Fma      , Ha^Fma      , Ha^Fma      , Ha^Fma      , Gg          , Gg          , Aa          , Gg          , Gg          , Gg          , Gg          , Aa          , Aa          , Gg          , Gg          , Ai          , Ww          , Ww          , Ai          , Aa          , Ai          , Aa          , Co          , Co          , 2 Ko        , Co          , Co          , Gg          , Ha          , Gg          , Ha^Fma      , Ha^Fma      , Ha^Fma      , Ha^Fma      , Ms          , Ms          , Ms          , Ms          , Ms          
Ms          , Ms          , Ms          , Ha^Fma      , Ha^Fma      , Ha^Fma      , Aa          , Aa          , Gg          , Gg          , Aa^Fma      , Aa^Fma      , Aa^Fma      , Aa          , Aa          , Aa          , Aa          , Aa          , Aa          , Gg          , Gg          , Gg          , Ai          , Ww          , Ww          , Ai          , Aa          , Aa          , Gg          , Gg          , Gg          , Co          , Gg          , Gg          , Gg          , Gg          , Gg          , Gg          , Gg          , Ha^Fma      , Ha^Fma      , Ha^Fma      , Ha^Fma      , Ms          , Ms          , Ms          
Ms          , Ms          , Ha^Fma      , Ha^Fma      , Ha^Fma      , Ha^Fma      , Gg          , Gg          , Gg          , Gg          , Aa^Fma      , Aa^Vea      , Aa          , Aa^Fma      , Gg          , Gg          , Gg          , Gg          , Gg          , Gg          , Ai          , Ai          , Ww          , Ww          , Ai          , Ai          , Aa          , Gg^Vo       , Gg          , Gg          , Gg          , Gg          , Gg          , Gg          , Gg          , Gg          , Aa          , Aa          , Aa          , Gg          , Gg          , Ha^Fma      , Ha^Fma      , Ms          , Ms          , Ms          
Ms          , Ms          , Ha^Fma      , Ha^Fma      , Ha^Fma      , Gg          , Aa          , Gg          , Aa          , Aa          , Aa^Fma      , Aa^Fma      , Gg          , Aa^Fma      , Gg          , Gg          , Gg          , Gg          , Gg          , Gg          , Ai          , Ww          , Ww          , Ai          , Ai          , Ai          , Gg          , Aa          , Gg          , Gg          , Gg          , Gg          , Gg          , Gg          , Gg          , Aa          , Aa          , Aa          , Aa          , Gg          , Gg          , Ha^Fma      , Aa^Fma      , Ms          , Ms          , Ms          
Ha^Fma      , Ha^Fma      , Ha^Fma      , Ha^Fma      , Gg          , Gg          , Aa^Fma      , Aa          , Aa          , Aa          , Aa^Fma      , Aa^Fma      , Aa^Fma      , Aa^Fma      , Aa^Fma      , Gg          , Gg          , Gg          , Gg          , Ai          , Ai          , Ww          , Ai          , Ai          , Aa          , Ai          , Aa          , Aa          , Gg          , Gg          , Aa          , Gg          , Aa          , Aa          , Gg          , Gg          , Gg          , Gg          , Gg          , Gg          , Gg          , Aa^Fma      , Aa^Fma      , Gg          , Ms          , Ms          
Ha^Fma      , Ha^Fma      , Gg          , Gg          , Gg          , Gg          , Aa^Fma      , Aa^Fma      , Aa^Fma      , Aa^Fma      , Aa^Fma      , Gg          , Gg          , Aa^Fma      , Gg          , Gg          , Gg          , Gg          , Ai          , Ai          , Ww          , Ww          , Ai          , Gg          , Aa          , Gg          , Aa          , Gg          , Gg          , Gg          , Gg          , Aa          , Gg          , Gg          , Gg          , Aa          , Aa          , Gg          , Gg          , Gg          , Aa          , Aa^Fma      , Aa^Fma      , Aa^Fma      , Gg          , Gg          
Aa^Fma      , Aa^Fma      , Gg          , Gg          , Gg          , Gg          , Aa          , Aa^Fma      , Gg          , Gg          , Gg          , Gg          , Gg          , Gg          , Ai          , Ai          , Ai          , Ai          , Ai          , Ai          , Ww          , Ww          , Ai          , Gg          , Aa          , Aa          , Gg          , Gg          , Aa          , Gg          , Gg          , Gg          , Gg          , Gg          , Gg          , Aa          , Aa          , Aa          , Aa^Voa      , Aa          , Aa^Fma      , Aa^Fma      , Aa^Fma      , Gg          , Gg          , Gg          
Aa^Fma      , Aa^Fma      , Gg          , Gg          , Aa^Fma      , Aa          , Gg          , Gg          , Gg          , Gg          , Gg          , Gg          , Gg          , Ai          , Ai          , Ai          , Ww          , Ai          , Ww          , Ww          , Ww          , Ai          , Ai          , Gg          , Gg          , Gg          , Aa          , Gg          , Aa          , Aa          , Gg          , Gg          , Aa          , Gg          , Gg          , Aa          , Aa          , Gg          , Aa          , Aa          , Aa          , Aa^Fma      , Aa^Fma      , Gg          , Gg          , Gg          
Aa^Fma      , Aa^Fma      , Aa^Fma      , Aa^Fma      , Aa^Fma      , Aa^Fma      , Gg          , Gg^Vo       , Gg          , Gg          , Aa          , Gg          , Gg          , Ai          , Ww          , Ww          , Aa^Fma      , Ww          , Ww          , Ww          , Ai          , Ai          , Ai          , Gg          , Aa          , Aa          , Aa          , Aa          , Gg          , Gg          , Aa          , Aa          , Aa          , Aa          , Aa          , Aa          , Aa          , Gg          , Gg          , Gg          , Gg          , Aa^Fma      , Aa          , Gg          , Gg          , Gg          
Aa          , Aa^Fma      , Aa^Fma      , Aa^Fma      , Aa^Fma      , Aa^Fma      , Gg          , Gg          , Gg          , Gg          , Gg          , Aa          , Aa          , Ai          , Ww          , Aa          , Aa          , Ww          , Ai          , Ai          , Aa^Fma      , Aa^Fma      , Gg          , Gg          , Aa          , Aa          , Gg          , Gg          , Gg          , Gg          , Gg          , Aa          , Gg          , Aa          , Aa          , Aa          , Aa^Fma      , Aa          , Aa^Fma      , Aa          , Aa          , Aa          , Gg          , Gg          , Aa          , Gg          
Aa          , Aa^Fma      , Aa          , Aa^Fma      , Gg          , Aa^Fma      , Gg          , Gg          , Gg          , Gg          , Aa          , Aa          , Gg          , Ai          , Ww          , Aa^Vea      , Ww          , Ai          , Ai          , Ai          , Aa^Fma      , Aa^Fma      , Gg          , Gg          , Gg          , Gg          , Gg          , Gg          , Gg          , Gg          , Gg          , Gg          , Gg          , Gg          , Aa^Fma      , Aa^Fma      , Aa^Fma      , Aa^Fma      , Aa^Fma      , Aa^Fma      , Gg          , Gg          , Gg          , Gg          , Aa          , Aa          
Gg          , Gg          , Aa^Fma      , Aa^Fma      , Aa^Fma      , Aa^Fma      , Aa          , Aa          , Gg          , Aa          , Aa          , Aa          , Ai          , Ai          , Ww          , Aa          , Ww          , Ww          , Ai          , Aa^Fma      , Aa^Fma      , Gg          , Gg          , Gg          , Gg          , Gg          , Aa          , Gg          , Aa^Voa      , Gg          , Aa          , Aa          , Gg          , Gg          , Aa^Fma      , Gg          , Aa^Fma      , Gg          , Gg          , Gg          , Gg          , Gg          , Gg          , Aa          , Aa          , Aa          
Aa^Fma      , Aa^Fma      , Aa^Fma      , Aa^Fma      , Aa^Vca      , Gg          , Aa          , Aa          , Gg          , Aa          , Aa          , Ai          , Ai          , Ww          , Ai          , Aa^Fma      , Ww          , Ww          , Ai          , Aa^Fma      , Aa^Fma      , Gg          , Gg          , Aa          , Gg          , Gg          , Aa          , Aa          , Aa          , Aa          , Aa          , Aa          , Aa          , Gg          , Gg          , Aa^Fma      , Aa^Fma      , Aa^Fma      , Gg          , Gg          , Gg          , Gg          , Gg          , Gg          , Aa          , Aa          
Gs^Fmw      , Aa^Fma      , Aa^Fma      , Aa          , Aa          , Aa          , Aa          , Gg          , Gg          , Aa          , Aa          , Ai          , Ww          , Ww          , Ww          , Aa^Fma      , Ai          , Ai          , Gg          , Gg          , Gg          , Gg          , Aa          , Gg          , Aa          , Gg          , Aa          , Gg          , Gg          , Aa          , Gg          , Aa          , Aa          , Aa          , Aa          , Gg          , Aa          , Aa          , Aa          , Gg          , Gg          , Gg          , Aa          , Gg          , Aa          , Aa          
Gs^Fmw      , Aa^Fma      , Gs^Fmw      , Gs^Fmw      , Gs^Fmw      , Aa          , Gg          , Gg          , Gg          , Aa          , Ai          , Ai          , Ww          , Ww          , Ai          , Ai          , Ai          , Ai          , Gg          , Gg          , Aa          , Aa          , Gg          , Aa          , Aa          , Aa          , Aa          , Aa          , Aa          , Gg          , Gg          , Gg          , Gg          , Gg          , Gg          , Aa          , Gg          , Aa          , Gg          , Aa          , Aa          , Gg          , Aa          , Aa          , Aa          , Aa          
Gs^Fmw      , Aa          , Gs^Fmw      , Gs^Fmw      , Gs^Fmw      , Gg          , Gg          , Gg          , Aa          , Aa          , Ai          , Ww          , Ww          , Ai          , Ai          , Ai          , Gg          , Gg          , Gg          , Aa          , Gg          , Gg          , Aa          , Aa          , Gs^Fmw      , Gg          , Aa          , Aa          , Aa          , Aa          , Aa          , Gg          , Gg          , Gg          , Gg          , Gg          , Gg          , Gg          , Gg          , Aa          , Aa          , Gg          , Aa          , Aa          , Aa          , Aa          
Gs^Fmw      , Gs^Fmw      , Gs^Fmw      , Gs^Fmw      , Gg          , Gg          , Gg          , Gg          , Aa          , Ai          , Ai          , Ww          , Ww          , Ai          , Ai          , Gg          , Gg          , Gg          , Gg          , Aa          , Aa          , Aa          , Aa          , Gs^Fmw      , Aa          , Gs^Fmw      , Gs^Fmw      , Gs^Fmw      , Gs^Fmw      , Gs^Fmw      , Gs^Fmw      , Aa          , Aa          , Gg          , Gg          , Gg          , Aa          , Aa          , Aa          , Aa          , Aa          , Gg          , Gg          , Gg          , Aa          , Aa          
Gs^Fmw      , Gs^Fmw      , Aa          , Aa          , Gg          , Gg          , Aa          , Aa          , Aa          , Ai          , Ai          , Ww          , Ww          , Ai          , Gg          , Gg          , Gg          , Gg          , Aa          , Aa          , Gg          , Gg          , Gg          , Aa          , Gs^Fmw      , Gs^Fmw      , Gs^Fmw      , Gs^Fmw      , Gs^Fmw      , Gs^Fmw      , Gs^Fmw      , Gs^Fmw      , Aa          , Aa          , Gg          , Gg          , Aa^Fma      , Aa          , Aa^Fma      , Aa          , Aa^Fma      , Aa^Fma      , Aa^Fma      , Gg          , Aa          , Gg          
Gs^Fmw      , Gs^Fmw      , Gs^Fmw      , Gg          , Gs^Fmw      , Aa          , Aa          , Aa          , Ai          , Ai          , Ww          , Ww          , Ww          , Ai          , Gg          , Gg          , Gg          , Aa          , Aa          , Aa          , Aa^Voa      , Aa          , Aa          , Aa^Fma      , Aa^Fma      , Aa          , Aa          , Gs^Fmw      , Gs^Fmw      , Gs^Fmw      , Aa          , Aa          , Aa          , Gg          , Aa^Fma      , Aa^Fma      , Aa          , Aa^Fma      , Aa^Fma      , Aa^Fma      , Aa^Fma      , Aa^Fma      , Aa^Fma      , Gg          , Gg          , Gg          
Gs^Fmw      , Gs^Fmw      , Gs^Fmw      , Gs^Fmw      , Gs^Fmw      , Aa          , Gg          , Gg          , Ai          , Ai          , Ww          , Gg          , Ww          , Ai          , Gg          , Gg          , Aa          , Gg          , Aa^Fma      , Gg          , Aa          , Aa          , Gg          , Aa^Fma      , Aa^Fma      , Aa^Fma      , Aa^Fma      , Gs^Fmw      , Gs^Fmw      , Gg          , Gg          , Aa          , Aa          , Aa          , Aa^Fma      , Aa          , Aa^Fma      , Aa^Fma      , Aa^Fma      , Aa^Fma      , Aa^Fma      , Aa          , Aa^Fma      , Gg          , Gg          , Gg          
Gs^Fmw      , Gs^Fmw      , Gs^Fmw      , Gg          , Gs^Fmw      , Gg          , Gg          , Gg          , Ai          , Ai          , Ww          , Ww          , Ai          , Ai          , Gg          , Gg          , Aa          , Gg          , Aa^Fma      , Aa^Fma      , Gg          , Gg          , Gg          , Aa^Fma      , Aa^Fma      , Aa^Fma      , Gs^Fmw      , Gs^Fmw      , Gs^Fmw      , Gs^Fmw      , Gg          , Aa          , Gg          , Gg          , Aa^Fma      , Aa^Fma      , Aa^Fma      , Aa^Fma      , Aa^Fma      , Aa^Fma      , Aa^Fma      , Aa          , Aa^Fma      , Gg          , Gg          , Gg          
Gs^Fmw      , Gs^Fmw      , Gs^Fmw      , Gs^Fmw      , Aa          , Gg          , Ai          , Ai          , Ww          , Ww          , Ww          , Ai          , Ai          , Gg          , Gg          , Gg          , Aa^Fma      , Aa^Fma      , Aa          , Gs^Fmw      , Gs^Fmw      , Gg          , Aa^Fma      , Aa^Fma      , Aa^Fma      , Aa^Fma      , Gs^Fmw      , Gs^Fmw      , Gs^Fmw      , Gg          , Gg          , Aa          , Gg          , Gg          , Aa^Fma      , Aa^Fma      , Aa^Fma      , Aa^Fma      , Aa^Fma      , Aa^Fma      , Aa^Fma      , Aa          , Aa^Fma      , Aa^Fma      , Gg          , Gg          
Aa          , Gs^Fmw      , Gs^Fmw      , Aa          , Aa          , Aa          , Ai          , Ai          , Ww          , Ww          , Ww          , Ai          , Ai          , Gg          , Aa^Fma      , Aa^Fma      , Aa^Fma      , Gg          , Gs^Fmw      , Gs^Fmw      , Aa^Fma      , Aa^Fma      , Aa^Fma      , Aa^Fma      , Gs^Fmw      , Aa^Fma      , Gs^Fmw      , Gs^Fmw      , Aa^Fma      , Gg          , Aa^Fma      , Aa          , Gg          , Gg          , Aa^Fma      , Aa^Fma      , Aa^Fma      , Aa^Fma      , Aa^Fma      , Aa^Fma      , Aa^Fma      , Aa          , Aa^Fma      , Aa^Fma      , Aa          , Gg          
Aa          , Aa          , Aa          , Aa          , Aa          , Aa          , Ai          , Ww          , Ww          , Ww          , Ai          , Ai          , Aa^Fma      , Aa^Fma      , Gs^Fmw      , Aa          , Aa          , Aa^Fma      , Gs^Fmw      , Gg          , Aa^Fma      , Aa^Fma      , Aa^Fma      , Gs^Fmw      , Gs^Fmw      , Gs^Fmw      , Gs^Fmw      , Gs^Fmw      , Aa^Fma      , Aa^Fma      , Aa^Fma      , Aa          , Aa          , Gg          , Aa          , Aa^Fma      , Aa^Fma      , Aa^Fma      , Aa^Fma      , Aa^Fma      , Gs^Fmw      , Aa          , Aa^Fma      , Aa^Fma      , Aa          , Aa          
Aa          , Aa          , Aa^Vca      , Aa          , Aa          , Ai          , Ww          , Ww          , Ww          , Ai          , Aa          , Aa          , Aa^Fma      , Aa^Fma      , Aa^Fma      , Gs^Fmw      , Gs^Fmw      , Gs^Fmw      , Gs^Fmw      , Gg          , Aa^Fma      , Aa^Fma      , Aa          , Aa^Fma      , Aa^Fma      , Gs^Fmw      , Aa^Fma      , Aa^Fma      , Aa^Fma      , Aa^Fma      , Aa          , Aa          , Gg          , Aa          , Gg          , Gg          , Gg          , Aa          , Gs^Fmw      , Gs^Fmw      , Gs^Fmw      , Gs^Fmw      , Gs^Fmw      , Gg          , Aa          , Aa          
Aa          , Aa          , Aa          , Aa          , Aa          , Ai          , Ww          , Ww          , Ai          , Ai          , Aa          , Aa          , Gg          , Aa^Fma      , Aa          , Aa^Fma      , Aa          , Gg          , Aa          , Aa          , Aa^Fma      , Aa          , Gg          , Aa          , Aa^Fma      , Aa^Fma      , Aa^Fma      , Aa^Fma      , Gg          , Aa          , Gg          , Gg          , Aa          , Aa          , Gg          , Gg          , Aa          , Aa          , Gs^Fmw      , Gs^Fmw      , Gs^Fmw      , Gs^Fmw      , Gs^Fmw      , Gs^Fmw      , Gs^Fmw      , Aa          
Aa          , Aa          , Aa          , Aa          , Ai          , Ai          , Ww          , Ai          , Gg          , Gg          , Aa          , Gg          , Gg          , Gg          , Gg^Vo       , Aa^Fma      , Aa^Fma      , Aa^Fma      , Aa^Fma      , Aa^Fma      , Aa          , Gg          , Ce          , Ce          , Ce          , Aa^Fma      , Aa          , Aa          , Gg          , Gg          , Gg          , Aa          , Gg          , Gg          , Aa          , Gg          , Gg          , Gs^Fmw      , Gs^Fmw      , Gs^Fmw      , Gs^Fmw      , Gs^Fmw      , Gs^Fmw      , Gs^Fmw      , Aa          , Aa          
Aa          , Aa          , Aa          , Aa          , Ai          , Ai          , Ww          , Ai          , Ai          , Gg          , Aa          , Aa          , Aa          , Aa          , Aa          , Gg          , Gg          , Gg          , Gg          , Aa          , Aa          , Ce          , Ce          , 1 Ke        , Ce          , Ce          , Aa          , Gg          , Gg          , Gg          , Aa^Vla      , Aa          , Aa          , Aa          , Gg          , Gg          , Gs^Fmw      , Gs^Fmw      , Gs^Fmw      , Gs^Fmw      , Gs^Fmw      , Gs^Fmw      , Gs^Fmw      , Gs^Fmw      , Aa          , Aa          
Aa          , Aa          , Ai          , Ai          , Ww          , Ww          , Ww          , Ww          , Ai          , Gg          , Gg          , Gg          , Gg          , Gg          , Gg          , Gg          , Gg          , Gg          , Gg          , Aa          , Aa          , Gg          , Gg          , Gg          , Gg          , Gg          , Aa          , Gg          , Gg          , Gg          , Gg          , Gg          , Gg          , Gg          , Gg          , Gs^Fmw      , Gs^Fmw      , Gs^Fmw      , Gg          , Gs^Fmw      , Gs^Fmw      , Gs^Fmw      , Aa          , Aa          , Aa          , Aa          
