border_size=1
usage=map

Ww          , Ww          , Ww          , Ww          , Ss          , Ss          , Ss          , Ss          , Ww          , Ss          , Ss          , Ss          , Ss          , Ss          , Ss          , Ss          , Ss          , Ss          , Ss          , Ss          , Ss          , Ss          , Ss          , Ss          , Ss          , Ss          , Ss          , Ss          , Ss          , Ss          , Ss          , Ss          , Ss          , Ss          , Ss          , Ss          , Ss          , Ss          , Ss          , Ss          , Ss          , Ss          , Ss          , Ss          , Ss          , Ss          
Ww          , Ww          , Ww          , Ww          , Ww          , Ss          , Ww          , Ww          , Ww          , Ss          , Ss          , Ss          , Ss          , Ss          , Ss          , Ss          , Ss          , Ss          , Ss          , Ss          , Ss          , Ss          , Ss          , Ss          , Ss          , Ss          , Ss          , Ss          , Ss          , Ss          , Ss          , Ss          , Ss          , Ss          , Ss          , Ss          , Ss          , Ss          , Ss          , Ss          , Ss          , Ss          , Ss          , Ss          , Ss          , Ss          
Ww          , Ww          , Ww          , Ww          , Ww          , Ww^Vm       , Ss          , Ww          , Ss          , Ss          , Ss          , Ss          , Rd          , Rd          , Ss          , Ss          , Ss          , Ss          , Gs^Ft       , Gs^Ft       , Ss          , Ss          , Ss          , Ss^Vm       , Ss          , Ss          , Ss          , Ss          , Ss          , Ss          , Ss          , Ss          , Chs         , Ss          , Ss          , Ss          , Ss          , Ss          , Ss^Vhs      , Ss          , Ss          , Ss          , Ss          , Ss          , Ss          , Ss          
Ww          , Ww          , Ww          , Ww          , Ss          , Ss          , Ss          , Ss          , Ss          , Ss          , Ss          , Rd          , Re^Vct      , Rd          , Ss          , Ss          , Ss          , Gs^Ft       , Ss          , Gs^Ft       , Ss          , Ss          , Ss          , Ss          , Ss          , Ss          , Ss          , Ss          , Ss          , Ss          , Ss          , Chs         , 2 Khs       , Chs         , Ss          , Ss          , Ss          , Ss          , Ss          , Ss          , Ss          , Ss          , Gs^Ft       , Ss          , Ss          , Ss          
Ss          , Ss^Vm       , Ss          , Ss          , Rd          , Ss          , Ss          , Ss          , Ss          , Ss          , Ss^Bw/      , Rd          , Rd          , Rd          , Ss          , Ss          , Ss          , Ss          , Ss          , Ss          , Ss          , Ss          , Rd          , Ss          , Ss          , Ss          , Ss          , Ss          , Ss          , Ss          , Ss          , Chs         , Chs         , Chs         , Ss          , Ss          , Ss^Bw\      , Ss          , Ss          , Ss          , Gs^Ft       , Gs^Ft       , Gs^Ft       , Gs^Ft       , Ss          , Ss          
Ss          , Ss          , Ss          , Rd          , Rd          , Ss          , Ss          , Ss          , Ss^Bw/      , Ss^Bw/      , Ss          , Ss          , Ss          , Ss          , Ss          , Ss          , Ss          , Ss          , Ss          , Ss          , Rd          , Rd          , Rd          , Ss^Bw\      , Ss^Bw\      , Ss          , Rd          , Ss          , Ss          , Ss          , Ss          , Ss          , Rd          , Ss          , Ss          , Ss          , Ss          , Ss^Bw\      , Ss^Bw\      , Ss          , Ss          , Gs^Ft       , Ss          , Ss          , Gs^Ft       , Ss          
Ss          , Ss          , Ss          , Ss          , Ss          , Rd          , Rd          , Ss^Bw/      , Ss          , Ss          , Ss          , Ss          , Ss          , Ss          , Ss          , Ss          , Ss          , Ss          , Rd          , Rd          , Ss          , Rd          , Ss          , Ss          , Ss          , Ss          , Ss          , Rd          , Rd          , Ss          , Rd          , Ss          , Rd          , Ss          , Ss          , Ss          , Ss          , Ss          , Ss          , Ss          , Ss          , Ss          , Ss          , Ss          , Gs^Ft       , Ss          
Ss          , Ss          , Ss          , Ss          , Ss          , Rd          , Ss^Vhs      , Ss          , Ss          , Ss          , Ss          , Ss          , Ss          , Ss          , Ss          , Ss          , Ss^Bw/      , Ss^Bw/      , Ss          , Ss          , Ss          , Ss          , Ss          , Ss          , Ss          , Ss          , Ss          , Ss          , Ss          , Rd          , Ss          , Ss          , Rd          , Ss          , Ss          , Ss          , Ss          , Ss          , Ss          , Ss          , Ss          , Ss^Bw\      , Ss^Bw\      , Rd          , Rd          , Ss          
Ss          , Ss          , Ss          , Ss          , Ss          , Rd          , Rd          , Rd          , Ss          , Ss          , Ss          , Ss          , Ss          , Ss          , Ss^Bw/      , Ss^Bw/      , Ss          , Ss          , Ss          , Ss^Vhs      , Ss          , Ss          , Ss          , Ss          , Ss          , Ss          , Ss          , Rd          , Ss^Bw\      , Ss          , Ss          , Ss          , Ss          , Ss          , Ss          , Ss          , Ss^Vhs      , Ss          , Rd          , Ss          , Ss          , Ss          , Rd          , Rd          , Rd          , Rd          
Ss          , Ss          , Ss          , Ss          , Ss          , Ss          , Ss          , Rd          , Ss          , Ss          , Ss          , Ss          , Rd          , Rd          , Ss          , Ss          , Ss          , Ss          , Ss          , Ss          , Rd          , Ss          , Rd          , Ss          , Rd          , Ss^Bw/      , Ss          , Ss          , Ss          , Ss^Bw\      , Rd          , Ss          , Rd          , Ss          , Ss          , Ss          , Ss^Bw/      , Rd          , Ss          , Rd          , Ss          , Ss          , Ss          , Rd          , Rd          , Rd          
Ss          , Ss          , Gs^Ft       , Gs^Ft       , Ss          , Ss          , Ss          , Ss          , Ss          , Ss          , Ss          , Ss          , Rd          , Ss          , Ss          , Ss          , Rd          , Chs         , 4 Khs       , Chs         , Ss          , Rd          , Ss          , Rd          , Ss          , Ss          , Ss          , Ss          , Ss          , Ss          , Rd          , Rd          , Ss^Vhs      , Rd          , Ss^Bw/      , Ss^Bw/      , Ss          , Ss          , Ss          , Ss          , Ss          , Ss          , Ss          , Ss          , Gs^Ft       , Gs^Ft       
Ss          , Ss          , Gs^Ft       , Gs^Ft       , Gs^Ft       , Ss          , Ss          , Ss          , Ss          , Ss          , Ss          , Ss          , Rd          , Rd          , Rd          , Rd          , Rd          , Rd          , Chs         , Ss          , Ss          , Ss          , Ss          , Ss          , Ss^Bw\      , Ss          , Ss          , Ss          , Ss          , Ss          , Ss          , Rd          , Rd          , Ss^Bw/      , Ss          , Ss          , Ss          , Ss          , Ss          , Ss          , Ss          , Ss          , Gs^Ft       , Gs^Ft       , Gs^Ft       , Gs^Ft       
Ss          , Ss          , Ss          , Gs^Ft       , Gs^Ft       , Ss          , Ss          , Rd          , Ss          , Ss          , Rd          , Ss          , Rd          , Ss          , Ss          , Ss          , Ss          , Ss          , Ss          , Ss          , Ss          , Ss          , Ss          , Ss          , Ss          , Ss^Bw\      , Ss          , Ss          , Ss          , Ss          , Ss          , Ss          , Ss          , Rd          , Ss          , Ss          , Ss          , Ss^Bw|      , Ss          , Ss          , Ss          , Ss          , Ss          , Gs^Ft       , Ss          , Gs^Ft       
Ss          , Ss          , Ss          , Ss          , Ss          , Ss          , Ss          , Rd          , Ss          , Ss          , Ss          , Rd          , Ss          , Ss          , Ss          , Ss          , Ss          , Ss          , Ss          , Ss          , Ss          , Ss          , Ss          , Ss          , Ss          , Ss          , Rd          , Rd          , Ss          , Ss          , Ss          , Ss          , Ss          , Ss          , Ss          , Ss          , Ss          , Ss^Bw|      , Ss          , Ss          , Ss          , Ss          , Ss          , Ss          , Ss          , Ss          
Ss          , Ss          , Ss          , Ss          , Ss          , Ss          , Ss          , Rd          , Rd          , Ss          , Ss          , Ss          , Rd          , Ss          , Ss          , Ss          , Ss          , Ss          , Gs^Ft       , Ss          , Ss          , Ss          , Ss          , Ss          , Ss          , Rd          , Ss          , Ss          , Ss          , Ss          , Ss          , Ss          , Ss          , Ss          , Ss          , Ss          , Ss          , Ss^Bw|      , Ss          , Ss^Vm       , Ss          , Ss          , Ss          , Ss          , Ss          , Ss          
Ss          , Ce          , Ce          , Ss          , Ss          , Ss          , Rd          , Rd          , Ss          , Ss          , Ss          , Ss          , Rd          , Rd          , Rd          , Ss          , Ss          , Gs^Ft       , Gs^Ft       , Ss          , Ss          , Ss^Vm       , Ss          , Ss          , Ss          , Ss          , Ss          , Ss          , Ss          , Rd          , Ss          , Ss          , Ss          , Ss          , Ss          , Ss          , Ss          , Ss          , Ss          , Ss          , Ss          , Ss          , Ss          , Ss          , Ss          , Ss          
Rd          , Ce          , Ce          , Ss          , Rd          , Ss          , Ss          , Ss          , Ss          , Ss          , Ss          , Ss          , Ss          , Ss          , Ss          , Rd          , Ss          , Gs^Ft       , Gs^Ft       , Ss          , Ss          , Ss          , Ss          , Ss          , Ss          , Ss          , Ss          , Ss          , Rd          , Ss          , Ss          , Ss          , Ss          , Ss          , Ss          , Ss          , Ss          , Ss^Bw|      , Ss          , Ss          , Ss          , Ss          , Gs^Ft       , Ss          , Ss          , Ss          
Rd          , Ce          , Ce          , Rd          , Ss          , Ss          , Ss          , Ss          , Ss          , Ss          , Ss          , Ss          , Ss          , Ss          , Ss          , Ss          , Ss          , Ss          , Ss          , Gs^Ft       , Ss          , Ss          , Rd          , Ss          , Ss          , Ss          , Rd          , Rd          , Ss          , Ss          , Ss          , Ss          , Ss          , Ss          , Rd          , Ss          , Ss          , Ss^Bw|      , Ss          , Ss          , Ss          , Gs^Ft       , Gs^Ft       , Ss          , Ss          , Ss          
Rd          , 1 Ke        , Ss          , Rd          , Rd          , Ss          , Ss          , Ss          , Ss          , Ss          , Ss          , Ss          , Ss          , Ss          , Ss          , Ss          , Ss          , Ss          , Rd          , Ss          , Rd          , Rd          , Ss          , Rd          , Ss          , Ss          , Ss          , Ss          , Ss          , Ss          , Ss          , Rd          , Rd          , Rd          , Ss          , Ss          , Ss          , Ss          , Ss          , Ss          , Ss          , Ss          , Ss          , Ss          , Ss          , Ss          
Ss          , Ss          , Ss          , Ss          , Ss          , Ss^Bw\      , Rd          , Ss          , Rd          , Ss          , Ss          , Ss          , Ss          , Ss          , Ss^Vhs      , Ss          , Ss          , Rd          , Rd          , Rd          , Ss          , Ss          , Ss          , Rd          , Rd          , Ss          , Ss          , Ss          , Ss          , Ss          , Ss          , Rd          , Rd          , Rd          , Ss          , Ss          , Chs         , Chs         , Chs         , Ss          , Ss          , Ss          , Ss          , Ss          , Ss          , Ss          
Ss          , Ss          , Ss          , Ss          , Ss          , Ss          , Ss          , Rd          , Ss          , Rd          , Rd          , Ss          , Ss          , Rd          , Rd          , Ss          , Ss          , Rd          , Ss          , Ss          , Ss^Bw\      , Ss          , Ss          , Ss          , Ss          , Ss          , Ss          , Ss          , Ss          , Ss          , Ss          , Ss          , Ss          , Ss          , Ss          , Ss          , Chs         , 3 Khs       , Chs         , Ss          , Ss          , Ss          , Ss          , Ss          , Ss          , Ss          
Ss          , Ss          , Ss          , Ss          , Ss          , Ss          , Ss          , Ss          , Ss          , Ss          , Ss          , Ss          , Ss          , Rd          , Ss          , Ss          , Ss          , Ss          , Ss          , Ss          , Ss          , Ss^Bw\      , Ss^Bw\      , Ss          , Ss          , Ss          , Ss          , Ss          , Ss          , Ss          , Ss          , Ss          , Ss          , Ss          , Ss          , Ss          , Ss          , Chs         , Ss          , Ss          , Ss          , Ss          , Ss          , Ss          , Ss          , Ss          
Ss          , Ss          , Ss          , Ss          , Ss          , Ss          , Ss          , Ss          , Ss          , Ss          , Ss          , Ss          , Ss          , Ss          , Ss          , Ss          , Ss          , Ss          , Ss          , Ss          , Ss          , Ss          , Ss          , Ss          , Ss          , Ss          , Ss          , Ss          , Ss          , Ss          , Ss          , Ss          , Ss          , Ss          , Ss          , Ss          , Ss          , Ss          , Ss          , Ss          , Ss          , Ss          , Ss          , Ss          , Ss          , Ss          
Ss          , Ss          , Ss          , Ss          , Ss          , Ss          , Ss          , Ss          , Ss          , Ss          , Ss          , Ss          , Ss          , Ss          , Ss          , Ss          , Ss          , Ss          , Ss          , Ss          , Ss          , Ss          , Ss          , Ss          , Ss          , Ss          , Ss          , Ss^Vm       , Ss          , Ss          , Ss          , Ss          , Ss          , Ss          , Ss          , Ss          , Ss          , Ss          , Ss          , Ss          , Ss          , Ss          , Ss          , Ss^Vm       , Ss          , Ss          
Ss          , Ss          , Ss          , Ss          , Ss          , Ss          , Ss          , Ss          , Ss          , Ss          , Ss          , Ss          , Ss          , Ss          , Ss          , Ss          , Ss          , Ss          , Ss          , Ss          , Ss          , Ss          , Ss          , Ss          , Ss          , Ss          , Ss          , Ss          , Ss          , Ss          , Ss          , Ss          , Ss          , Ss          , Ss          , Ss          , Ss          , Ss          , Ss          , Ss          , Ss          , Ss          , Ss          , Ss          , Ss          , Ss          
