border_size=1
usage=map

Gg          , Gg          , Gg          , Gg          , Gs^Fmw      , Gs^Fmw      , Gg          , Gs^Fmw      , Gs^Fmw      , Hh^Fmw      , Gs^Fmw      , Hh^Fmw      , Gs^Fmw      , Gg          , Hh^Fmw      , Gg          , Hh^Fmw      , Gg          , Hh^Fmw      , Hh^Fmw      , Hh^Fmw      , Hh^Fmw      , Hh^Fmw      , Gg          , Hh^Fdw      , Hh^Fdw      , Hh^Fdw      , Hh^Fdw      , Hh^Fdw      , Gg          , Hh^Fdw      , Gg          , Hh^Fdw      , Gg          , Hh^Fdw      , Hh^Fdw      , Hh^Fdw      , Hh^Fdw      , Hh^Fdw      , Hh^Fdw      , Hh          , Hh          
Ww          , Gg          , Gg          , Gs^Fmw      , Gg          , Gs^Fmw      , Gg          , Gg          , Gg          , Gs^Fmw      , Gs^Fmw      , Gs^Fmw      , Gg          , Gs^Fmw      , Gs^Fmw      , Hh^Fmw      , Gs^Fmw      , Gs^Fmw      , Gs^Fmw      , Gs^Fmw      , Gs^Fmw      , Gs^Fmw      , Gs^Fmw      , Hh^Fmw      , Hh^Fmw      , Hh^Fdw      , Hh^Fmw      , Hh^Fdw      , Hh^Fmw      , Hh^Fdw      , Hh^Fdw      , Hh^Fdw      , Hh^Fmw      , Gs^Fmw      , Gs^Fmw      , Gs^Fmw      , Gs^Fmw      , Hh^Fdw      , Hh          , Hh          , Hh          , Hh          
Ww          , Ww          , Ww          , Gg          , Gg          , Gg          , Gg          , Gg          , Gg          , Gs^Fmw      , Gg          , Gs^Fmw      , Gs^Fmw      , Gs^Fmw      , Gg          , Gs^Fmw      , Gg          , Gs^Fmw      , Gg          , Gg          , Gg          , Gs^Fmw      , Gs^Fmw      , Gs^Fmw      , Gs^Fmw      , Gs^Fmw      , Gs^Fmw      , Hh^Fmw      , Hh^Fmw      , Hh^Fdw      , Hh^Fdw      , Hh^Fmw      , Hh^Fmw      , Gs^Fmw      , Gg          , Gs^Fmw      , Ce          , Hh^Fdw      , Hh^Fdw      , Hh          , Hh          , Hh          
Wo          , Gg          , Wo          , Ww          , Ww          , Gg          , Gg          , Gg          , Gg          , Gs^Fmw      , Gs^Fmw      , Gs^Fmw      , Gg          , Gg          , Gg          , Gg          , Gg          , Gg          , Gg          , Gg          , Gg          , Gg          , Gg          , Gs^Fmw      , Gg          , Gs^Fmw      , Gg          , Gs^Fmw      , Gg          , Hh^Fmw      , Hh^Fmw      , Hh^Fmw      , Hh^Fmw      , Hh^Fmw      , Gg          , Ce          , Ce          , Ce          , 2 Ke        , Hh          , Hh          , Hh^Fdw      
Wo          , Wo          , Wo          , Ww          , Ww          , Gg          , Ww          , Gg          , Ww          , Gg          , Gg          , Gg          , Gg          , Gg          , Gg          , Gg          , Gg          , Gg          , Gg          , Ww          , Ww          , Gg          , Gg          , Gg          , Gg          , Gg          , Gg          , Gg          , Gg          , Gg          , Gg          , Gg          , Gg          , Gg          , Gg          , Gg          , Gg          , Ce          , Ce          , Hh^Fdw      , Hh^Fdw      , Hh^Fdw      
Wo          , Wo          , Wo          , Wo          , Wo          , Ww          , Wo          , Ww          , Wo          , Ww          , Ww          , Ww          , Ww          , Gg          , Ww          , Gg          , Ww          , Ww          , Ww          , Ww          , Ww          , Ww          , Ww          , Gg          , Gg          , Gg          , Gg          , Gg          , Gg          , Gg          , Gg          , Gg          , Gg          , Gg          , Gg          , Gg          , Gg          , Gg          , Gg          , Gg          , Gg          , Hh^Fdw      
Wo          , Wo          , Wo          , Wo          , Wo          , Wo          , Wo          , Wo          , Wo          , Wo          , Wo          , Wo          , Wo          , Ww          , Ww          , Ww          , Wo          , Ww          , Wo          , Wo          , Wo          , Ww          , Ww          , Gg          , Ww          , Gg          , Ww          , Gg          , Ce          , Gg          , Ce          , Gg          , Gg          , Gg          , Gg          , Gg          , Gg          , Gg          , Gg          , Gg          , Gs^Fdw      , Gg          
Gg          , Wo          , Wo          , Wo          , Wo          , Wo          , Wo          , Wo          , Wo          , Wo          , Wo          , Wo          , Wo          , Wo          , Wo          , Wo          , Wo          , Wo          , Wo          , Wo          , Wo          , Wo          , Wo          , Ww          , Ww          , Ww          , Wo          , Ww          , Gg          , Gg          , Gg          , Ce          , Ce          , Gg          , Gg          , Gg          , Gg          , Gg          , Gg          , Gs^Fdw      , Gs^Fdw      , Gs^Fdw      
Ww          , Ww          , Ww          , Wo          , Ww          , Wo          , Wo          , Wo          , Wo          , Wo          , Wo          , Wo          , Wo          , Wo          , Wo          , Wo          , Wo          , Wo          , Wo          , Wo          , Wo          , Wo          , Wo          , Wo          , Wo          , Wo          , Wo          , Ww          , Ww          , Gg          , Gg          , Gg^Vo       , Gg          , Gg          , Ce          , Gg          , Gg          , Gg          , Gg          , Gs^Fdw      , Gs^Fdw      , Gs^Fdw      
Gg          , Gg          , Gg          , Ww          , Gg          , Ww          , Ww          , Wo          , Gg          , Gg^Ve       , Gg          , Wo          , Gg          , Wo          , Wo          , Wo          , Ww          , Ww          , Ww          , Ww          , Ww          , Wo          , Ww          , Wo          , Wo          , Wo          , Wo          , Wo          , Ww          , Ww          , Gg          , Gg          , Gg          , Gg          , Gg          , Ce          , Ce          , Gg          , Gg          , Gg          , Gs^Fdw      , Gs^Fdw      
Gg          , Gg          , Gg          , Gg          , Re^Gvs      , Gg          , Gg          , Ww          , Ww          , Ww          , Ww          , Ww          , Ww          , Ww          , Gg          , Ww          , Gg          , Gg          , Ce          , Ce          , Gg          , Ww          , Gg          , Ww          , Ww          , Wo          , Wo          , Wo          , Wo          , Ww          , Ww^Bw/      , Gg          , Gg          , Gg          , Gg          , Gg          , Gg          , Ce          , Gg          , Gg          , Gg          , Gg          
Gg          , Gg          , Gg          , Re^Gvs      , Re^Gvs      , Re^Gvs      , Re^Gvs      , Gg          , 3 Gg        , Gg          , Gg          , Gg          , Ww          , Ww          , Gg          , Gg          , Ce          , Ce          , Gg          , Gg          , Gg          , Gg          , Gg^Vh       , Gg          , Ww          , Wo          , Wo          , Wo          , Wo^Bw/      , Ww^Bw/      , Wo^Bw/      , Ww^Bw/      , Gg          , Ww          , Ww          , Gg          , Gg          , Gg          , Gg          , Gg          , Gg          , Gg          
Gs^Fmw      , Gs^Fmw      , Gs^Fmw      , Gg          , Gg          , Re^Gvs      , Gg          , Gg          , Gg          , Gg          , Gg          , Gg          , Ww          , Ww          , Gg          , Gg          , Gg          , Gg          , Gg          , Gg          , Gg          , Gg          , Gg          , Gg          , Gg          , Ww          , Ww^Bw/      , Wo^Bw/      , Wo^Bw/      , Wo^Bw/      , Wo          , Ww          , Ww          , Wo^Bw\      , Gg          , Wo^Bw/      , Ce          , Ce          , Gg          , Gs^Fmw      , Gs^Fmw      , Gg          
Gs^Fmw      , Gs^Fmw      , Gs^Fmw      , Gs^Fmw      , Gs^Fmw      , Gs^Fmw      , Gg          , Gg          , Gg          , Gg          , Ww          , Ww          , Gg          , Gg          , Ce          , Ce          , Gg          , Gg          , Gg          , Gg          , Gg          , Gg          , Gg          , Gg          , Rd          , Rd          , Rd          , Ww^Bw/      , Ww          , Wo          , Wo          , Wo          , Wo          , Ww          , Ww          , Ww          , Gg          , Gg          , Gg          , Gs^Fmw      , Gs^Fmw      , Gg          
Gs^Fmw      , Gs^Fmw      , Gs^Fmw      , Gs^Fmw      , Gs^Fmw      , Gs^Fmw      , Gg          , Gg          , Gg          , Ww          , Ww          , Gg          , Gg          , Gg          , Ce          , Gg          , Gg          , Gg^Vo       , Gg          , Gg          , Rd          , Rd          , Rd          , Rd          , Gg          , Gg          , Gg          , Gg          , Gg          , Ww          , Ww          , Wo          , Wo          , Wo          , Wo          , Ww          , Ww          , Gg          , Gg          , Gg          , Gg          , Gg          
Gs^Fmw      , Gs^Fmw      , Gs^Fmw      , Gs^Fmw      , Gs^Fmw      , Gs^Fmw      , Gg          , Gg          , Gg          , Ww          , Ww          , Gg          , Gg          , Gg          , Ce          , Gg          , Gg          , Gg          , Gg          , Gg          , Rd          , Ce          , 1 Ke        , Rd          , Gg          , Gg          , Gg          , Gg^Vh       , Gg          , Gg          , Ww          , Gg          , Wo          , Wo          , Wo          , Wo          , Wo          , Ww          , Gg          , Gs^Fdw      , Gs^Fdw      , Gg          
Rd          , Rd          , Rd          , Gs^Fmw      , Gg          , Gg          , Rd          , Gg          , Wwf         , Ww          , Rd          , Gg          , Rd          , Gg          , Rd          , Rd          , Rd          , Rd          , Rd          , Rd          , Rd          , Ce          , Ce          , Rd          , Gg          , Gg          , Gg          , Gg          , Gg          , Gg          , Ww          , Ww          , Ww          , Wo          , Wo          , Wo          , Wo          , Ww          , Gg          , Gs^Fdw      , Gs^Fdw      , Gs^Fdw      
Gs^Fmw      , Gs^Fmw      , Gs^Fmw      , Rd          , Rd          , Rd          , Gg          , Rd          , Wwf         , Rd          , Gg          , Rd          , Gg          , Rd          , Ce          , Gg          , Gg          , Gg          , Gg          , Gg          , Rd          , Ce          , Rd          , Rd          , Rd          , Gg          , Gg          , Gg^Vo       , Gg          , Gg          , Gg          , Gg          , Gg          , Ww          , Wo          , Wo          , Wo          , Ww          , Ww          , Gg          , Gs^Fdw      , Gs^Fdw      
Gs^Fmw      , Gs^Fmw      , Gg          , Gg          , Gg          , Gg          , Ww          , Gg^Vl       , Ww          , Gg          , Gg          , Gg          , Gg          , Gg          , Ce          , Gg^Vo       , Gg          , Gg          , Gg          , Gg          , Rd          , Rd          , Gg          , Gg          , Gg          , Rd          , Re^Gvs      , Re^Gvs      , Re^Gvs      , Gg          , Gg          , Gg          , Gg          , Ww          , Wo          , Wo          , Wo          , Ww          , Gg          , Gg          , Gg          , Gg          
Gg          , Gg          , Ww          , Ww          , Ww          , Ww          , Gg          , Ww          , Gg          , Gg          , Gg          , Gg          , Gg          , Gg          , Gg          , Ce          , Ce          , Gg          , Gg          , Gg          , Rd          , Gg          , Gg          , Gg          , Gg^Vo       , Rd          , Gg          , Re^Gvs      , Re^Gvs      , Re^Gvs      , Gg          , Gg          , Ww          , Ww          , Wo          , Wo          , Wo          , Ww          , Gg          , Gg          , Gg          , Gg          
Ww          , Ww          , Gg          , Ww          , Gg          , Gg          , Gg          , Gg          , Gg          , Gg          , Re^Gvs      , Re^Gvs      , Re^Gvs      , Gg          , Gg          , Gg          , Gg          , Ce          , Ce          , Rd          , Rd          , Gg          , Gg          , Gg          , Gg          , Rd          , Gg          , Gg          , Gg          , Gg          , Gg          , Ww          , Wo          , Wo          , Wo          , Wo          , Ww          , Ww          , Ww          , Gg          , Gg          , Gg          
Ww          , Gg          , Gg          , Gg          , Gg          , Gg          , Gs^Fmw      , Gg          , Gg          , Gg          , Gg          , Re^Gvs      , Re^Gvs      , Re^Gvs      , Gg          , Gg          , Gg          , Gg          , Rd          , Rd          , Ce          , Gg          , Gg          , Gg          , Ce          , Rd          , Ce          , Gg          , Gg^Vo       , Gg          , Ww          , Ww          , Wo          , Wo          , Wo          , Wo          , Ww          , Ww          , Gg          , Gg          , Gg          , Gg          
Gg          , Gg          , Gg          , Gg          , Gg          , Gs^Fmw      , Gg          , Gs^Fmw      , Gs^Fmw      , Gs^Fmw      , Gs^Fmw      , Gg^Vc       , Gg          , Gg          , Gg          , Gg          , Gg          , Gg          , Rd          , Gg          , Gg          , Ce          , Ce          , Ce          , Gg          , Rd          , Gg          , Ce          , Ce          , Ce          , Ww          , Wo          , Wo          , Wo          , Ww          , Ww          , Gg          , Gg          , Gs^Fmw      , Gs^Fmw      , Gs^Fmw      , Gg          
Gg          , Gg          , Gg          , Gg          , Gg          , Gg          , Gg          , Gg          , Gg          , Gs^Fmw      , Gs^Fmw      , Gg          , Gg          , Gg          , Gg          , Gg          , Gg          , Gg          , Rd          , Gg          , Gg          , Gg          , Gg          , Gg          , Rd          , Rd          , Re^Gvs      , Gg          , Gg          , Gg          , Ww          , Wo          , Wo          , Wo          , Ww          , Gg          , Gg          , Gs^Fmw      , Gs^Fmw      , Gs^Fmw      , Gs^Fmw      , Gs^Fmw      
Gg          , Gg          , Gg          , Gg          , Re^Gvs      , Re^Gvs      , Re^Gvs      , Gg          , Gg^Vc       , Gs^Fmw      , Gs^Fmw      , Gs^Fmw      , Gs^Fmw      , Gs^Fmw      , Gg          , Gg          , Gg          , Gg          , Rd          , Rd          , Rd          , Gg          , Rd          , Rd          , Gg          , Re^Gvs      , Re^Gvs      , Re^Gvs      , Re^Gvs      , Gg          , Gg          , Ww          , Wo          , Wo          , Wo          , Ww          , Ww          , Ww          , Ww          , Gg          , Gg          , Gs^Fmw      
Gg          , Gg          , Gg          , Gg          , Gg          , Re^Gvs      , Re^Gvs      , Re^Gvs      , Re^Gvs      , Gg          , Gg          , Gg          , Gg          , Gg          , Gg          , Gg          , Gg          , Rd          , Gg          , Gg          , Gg          , Rd          , Gg          , Gg^Vc       , Gs^Fmw      , Gg          , Gg          , Re^Gvs      , Gg          , Gg          , Ww          , Ww          , Wo          , Wo          , Wo          , Wo          , Ww          , Ww          , Ww          , Ww          , Gg          , Gg          
Gg          , Gg          , Gg          , Gg          , Gg          , Gg          , Gg          , Re^Gvs      , Gg          , Gg          , Gg          , Gg          , Gg          , Gg          , Gg          , Gg          , Rd          , Rd          , Gg          , Gs^Fmw      , Gs^Fmw      , Gs^Fmw      , Gs^Fmw      , Gs^Fmw      , Gs^Fmw      , Gg          , Gg          , Gg          , Ww          , Ww          , Ww          , Wo          , Wo          , Wo          , Wo          , Wo          , Ww          , Gg          , Gg          , Ww          , Ww          , Gg          
Gg          , Gg          , Gg          , Gg          , Gg          , Gg          , Gg          , Gg          , Gg          , Gg          , Gg          , Gg          , Gg          , Gg          , Gg          , Gg          , Rd          , Gg          , Gg          , Gg          , Gg          , Gg          , Gg          , Gg          , Gg          , Gg          , Gg          , Gg          , Gg          , Ww          , Wo          , Wo          , Wo          , Wo          , Wo          , Ww          , Gg          , Ww          , Ww          , Ww          , Wo          , Gg          
